%%%%%%
% S  %
%    %
%    %
%%%%%%
