%%%%%%%%%%%%%%%%%%%%%%
%                  A %
%   S                %
%                    %
%                    %
%                    %
%              S     %
%                    %
%                    %
%                    %
%%%%%%%%%%%%%%%%%%%%%%
