%%%%%%%%%%%
%         %
% S       %
%         %
%       S %
%         %
%%%%%%%%%%%
