######
# S  #
#    #
#    #
######
