%%%%%%
%S   %
%    %
%    %
%   S%
%%%%%%
