%%%%%%%%%
%       %
%       %
%       %
%  %    %
%AY %   %
%%%%%%%%%
