%%%%%%%%%%%%%%%%%%%%%%%%%%%%%%%%%%%%%%%%%%%%
%                                          %
%                                          %
%                               S          %
%                                          %
%                                          %
%                                          %
%                                          %
%                                          %
%                                          %
%                  A                       %
%                                          %
%                                          %
%                                          %
%    S                                     %
%                                          %
%                                          %
%                                          %
%                                          %
%%%%%%%%%%%%%%%%%%%%%%%%%%%%%%%%%%%%%%%%%%%%