###########
#         #
# S       #
#      A  #
#         #
#         #
###########
