%%%%%%%%%%%
%         %
% S       %
%     A   %
%         %
%         %
%%%%%%%%%%%
