###########
#         #
# S       #
#         #
#  A    S #
#         #
###########
