%%%%%%%%%%%
%         %
% S       %
%         %
%       S %
%  A      %
%%%%%%%%%%%
