######
#S   #
#  A #
#   S#
######
