######
#S   #
#    #
#   S#
######
