%%%%%%
% S  %
%    %
%  A %
%%%%%%
