%%%%%%
%S   %
%    %
% A  %
%   S%
%%%%%%
