######
# S  #
#    #
#   A#
######
